66
5, 53
9, 14
00000000000000000
00000000000000000
00000000000000000
00000000000000000
00000000000000000
00000000000000000
00000000000000000
00000000000000000
00000000000000000
00000000000000000
00000000000000000
00000000000000000
00000000000000000
00000000000000000
00000001110000000
00000010000110000
00000100000001000
00001110000000100
00000000000001000
00011100000111000
00000000000000000
00110000000011100
00001100000000000
00000000000111000
00001100000000000
00000000000111000
00001100000000000
00110000000110000
00000000000001000
00110000000010000
01000000000101000
00110000000010100
00001100000001000
00000000000010000
00011110000101000
00000000000000000
00000001110111100
00001100000000000
00110000000001100
01000000000010000
00000000000001000
00110000000000100
00000100000000010
00111000000000100
01000000000011000
00100000000100000
00010000000010000
00001000000001000
00000100000000100
00001000000001110
00010000000000000
00000000000011100
01100011111000000
00011100000111000
00000000000000000
00000000000000000
00000000000000000
00000000000000000
00000000000000000
00000000000000000
00000000000000000
00000000000000000
00000000000000000
00000000000000000
00000000000000000
00000000000000000
