5,40
11,2
00000000000000000
00000000000000000
00001000111110000
00100000000000100
00000010001000000
00100000000010000
00000100100000100
00010010000000000
00000000001001000
00101001000100000
00000000000000000
00010100001110000
00000000100000000
01010001000001000
00000000000000000
01101101100011000
00000000000000000
00000000011000110
00000000000000000
00000011100011000
00000000011000000
00000111000000000
00100001000110000
00001110000000000
00000010000001100
00011100001100000
00000100000000000
00111000110011000
00000000000000000
11110010001100110
00000000100000000
00001100000011000
00100010010000000
00000000000000000
00110001001110000
00000111100000000
00111001010000000
00000010001001100
11000000000000000
00001100001100000
00000000000000000
11110011110011110
00000000000000000
00000000000000000
00000000000000000
00000000000000000
00000000000000000
00000000000000000
