5,40
11,2
0000000000000000
0000000000000000
0000100011111000
0010000000000010
0000001000100000
0010000000001000
0000010010000010
0001001000000000
0000000000100100
0010100100010000
0000000000000000
0001010000111000
0000000010000000
0101000100000100
0000000000000000
0110110110001100
0000000000000000
0000000001100011
0000000000000000
0000001110001100
0000000001100000
0000011100000000
0010000100011000
0000111000000000
0000001000000110
0001110000110000
0000010000000000
0011100011001100
0000000000000000
1111001000110011
0000000010000000
0000110000001100
0010001001000000
0000000000000000
0011000100111000
0000011110000000
0011100101000000
0000001000100110
1100000000000000
0000110000110000
0000000000000000
1111001111001111
0000000000000000
0000000000000000
0000000000000000
0000000000000000
0000000000000000
0000000000000000
