65
5,52
15,13
00000000000000000
00000000000000000
00000000000000000
00000000000000000
00000000000000000
00000000000000000
00000000000000000
00000000000000000
00000000000000000
00000000000000000
00000000000000000
00000000000000000
00111110000000000
00000000010000111
00100001000010000
00010000000000000
00001000000101000
00010000000000000
00000000000010100
00010010010000000
00000000100101010
00101101000000000
00000000000000000
00010000010100100
01000100000001010
00010000100001000
00001000110000100
00000010000100100
00001010000000100
00010010010001000
00100000000000000
00001000000010100
01000010001000100
00010000100000000
00000100001010000
00010001000000000
00100000010101000
00100101000000100
00010000001001010
00001000000100000
00000010100010010
00100000100001000
00001010000000000
00000000100111000
00100010000000000
00001000000100000
00000001000001000
00010000011000000
01000100011000000
00010000011000000
00101000011000000
00000000000000000
11111111111111111
00000000000000000
00000000000000000
00000000000000000
00000000000000000
00000000000000000
00000000000000000
00000000000000000
00000000000000000
00000000000000000
00000000000000000
00000000000000000
00000000000000000
