66
14, 53
9, 13
00000000000000000
00000000000000000
00000000000000000
00000000000000000
00000000000000000
00000000000000000
00000000000000000
00000000000000000
00000000000000000
00000000000000000
00000000000000000
00000000000000000
00000000000000000
00000001110000000
00000000001100000
01110000000011110
00000000000000000
00000110001100000
00000000000000000
00000001110000000
00000010001000000
00000010001000000
00000010001000000
00001101110010000
00010000000000000
01100000000011000
00000000000000000
00011000000011000
01100000000000111
00000000000000000
00011000000011000
00100000000000110
01000000000000000
01110000000011100
00000000000000000
00011000000000110
10000000000000000
01100000000001110
00000000011100000
00011100000000000
00000001110000000
00000010001000000
00000010001000000
00000010001000000
01110001110001110
00001100000110000
00000000000000000
00010000000001000
00000000000000000
00001100000110000
00000000000000000
00000011111000110
00000000000000000
11111000000011111
00000000000000000
00000000000000000
00000000000000000
00000000000000000
00000000000000000
00000000000000000
00000000000000000
00000000000000000
00000000000000000
00000000000000000
00000000000000000
00000000000000000
00000000000000000
